####################
#..................#
#..................#
#..................#
#.......##.........#
#..................#
#........##........#
#.###..............#
#..................#
#..................#
####################