^^^^^^^^^^^^^^^^^^^^
^..................^
^..................^
^..................^
^.......##.........^
^..................^
^........##........^
^.###..............^
^..................^
^..................^
^^^^^^^^^^^^^^^^^^^^