^^^^^^^^^^^^^^^^^^^^
^..................^
^..................^
^.....^^...........^
^.......##.........^
^..................^
^........##........^
^.###.....^^^^.....^
^..................^
^..................^
^^^^^^^^^^^^^^^^^^^^