^^^^^^^^^^^^^^^^^^^^
^..................^
^..................^
^####^^^^..^^^^####^
^......#....#......^
^.....^^....^^.....^
^.......#...#......^
^####^^^^..^^^^####^
^..................^
^..................^
^^^^^^^^^^^^^^^^^^^^