^^^^^^^^^^^^^^^^^^^^
^..................^
^..................^
^....^^^^..^^^^....^
^.#..............^.^
^.....^^....^^..^^.^
^..^...............^
^....^^^^......####^
^.###..............^
^..................^
^^^^^^^^^^^^^^^^^^^^