^^^^^^^^^^^^^^^^^^^^
^..................^
^..................^
^....^#^^..^^^^....^
^.#..............^.^
^.....^^....^^..^^.^
^..^...............^
^....^^^^......####^
^.###...............^
^..................^
^^^^^^^^^^^^^^^^^^^^