^^^^^^^^^^^^^^^^^^^^
^..................^
^...^..^##^........^
^.....^^..^^.......^
^......^..^....^^..^
^.....^....^.......^
^...#........#..^..^
^.^^^..........^^^.^
^......^^^^^.......^
^..................^
^^^^^^^^^^^^^^^^^^^^