^^^^^^^^^^^^^^^^^^^^
^..................^
^.^^^^^#####^^^^^^.^
^.^..##.....##...^.^
^.#..##.....##...#.^
^.#..##.....##...#.^
^.^..##.....##...^.^
^.^^^^^#####^^^^^^.^
^..................^
^..................^
^^^^^^^^^^^^^^^^^^^^