^^^^^^^^^^^^^^^^^^^^
^..................^
^..................^
^..####..#..#####..^
^..................^
^...####....####...^
^....###....###....^
^..................^
^.###...###...####.^
^..................^
^^^^^^^^^^^^^^^^^^^^